################################################################################################################################
########################################################..................................######################......##########
###.....####################...#######...##############....####....####.......#####..####..#############....................####
##.......###################...######......##.....#####........................###....#.....###########.....................####
##.......####################...#####..............####.....................................#####..####.....................####
##........############...####......................####.....................................###.....###.....................####
##...........########.....###......................####........###.........................###.......###.....................###
##............######......###......................###.........####..............##........###........#.......................##
###...........#####.......###......................##..........####..........#######...........................................#
###..........####..........#......................###....###...####.........########...........................................#
###..........###.................................####...####...####.........#######...........................................##
###..........###................................#####...###...####..........#######...........................................##
##.............................................#######..###..####............#######.........................................###
##..........................................##########..#########............#######........................................####
##........................................############...#########...........#######........................................####
##...........................##..........########........##########.........#####............................................###
###.........................####.........######...........##########........####.............................................###
##########........##....########.........#####............##########.........##................................................#
##########........##############..........####............###########................###..................#...........##.......#
#########..........#############...........##..............###....#######..........#####.................###...........#......##
###....#............############...................................######.........#####.................###.............##....##
##......#............##########....................................#####..........####..................##......##.......##..###
##.....###...............######....................#................####...........###.................###.....####......#######
##....####................#####...................###...##..........####...........###................#####..######......#######
##....###...................##....................##########........#####..........................################.......######
###................................................############.....######.........................####..##########..........###
###..........##.......#............................###......####....######..........................##.....########...........##
##..........####.....###............#.............####.......###.....#####......###........................########...........##
##..........####.....###...........###...........#####.......###................###........................#######.....#......##
##...........####...###..........................#####.......###........................................#########......##......#
###..........#########....................###....####........###.......................................#########.......#.......#
###....###############.......##...........####...###.........###.......................................########................#
##....################.......###............##..####.........####.....................##...............########...............##
##...###########...##........#########........#####...........####..................#####..................###...............###
###.###########...............#########.......####............#####............##########.....##............................####
############...................#######.........##.............######.......#############.....####...........................####
###########.....................#####.........................#########################......####...........................####
#####..####......................####.........................#################....####.....#####............................###
#####...###.......................##.........................#################......##....#######.........###.................##
#####......................................................#############..###.............########........####.....###........##
#####...................................##...............##############...................########.........####...#####.......##
####...................................####.............#########............................#####..........###########......###
###...................................#####.............#########............................#####..........###########......###
##....................................######............########...........................########.........##########.......###
##....................................######............#####.............................############......##########.......###
##.....................................####.............####........#.....................#############.....##########......####
##.........#####........##...............................##.........##.....................#############....###########....#####
##........#######......####........................................................###.....#############.....###########..######
##........#######.....#####.......................................................#####...########...##.............####..######
##...##..#######......#####.......................................................#####...###..##....................##..#######
##..#########.........######................................................#.....####....##.............................###..##
##..########..........######..........##..................##..............####....####....##..................###..............#
##...######...........#####...........###.................###............####.....#######.##.......###.......#####.............#
##...................#####............###.................#####..........###......#######.#......######......#####.............#
##...................#####............####.................#####.........##........######.....#########......#####.............#
##....................####............####.................#####....................#####....##########.......###.............##
###....................###.............##..................#####....................####.....##########..............##......###
####...................###...................##...........#####......................##.......##########............####....####
######.................###.................#####.........####..................................#########............####....####
#######...............####................#######........###...................................########..............###....####
#######...............#####..............########........###....##.............................####.........................####
######..................####....##......##########.......####....#.............................####........................#####
######...................##########.....##########.......####.............##....................###.......................######
######....................#####..###....#####.####........##......##########.....................###.....................#######
######.....................###....###....###...###...............########........................####....................#######
#####.............................####....#....###...............#####...........................#########.........###...#######
####...............................###.........##.................###.........................#############.......#####..#######
#####..................###....................###............................................##############.......#####..#######
#######................###....................###............................................########..####.......####...#######
########...............###.......#............###............................................#######....##.........##....#######
#########.......................###...........####...........................................######.......................######
#########....................................######...............############................#####..........................###
##########..................................#######..............##############................###............................##
############...............................#######...............######....#####...............................................#
#############.............................#######................#####......####...............................................#
#############...........................########.................####........###........................####....###............#
############...........................#########................#####.................................######...####...........##
############...........................########................######................................#######...###...........###
##..###..###............................######..............#########............##..................####.....###....##......###
#.........###........................................###...##########...........####..................##......##...#####.....###
#.........###.............##........................################............####.........................####.#######....###
##.......####............####.......##.........##...##############.......###....#####..##........##.........##############....##
###.....#####............#####.....####.......####...############.....#######...#########....#..####......#########.#######...##
####....####..............####.....#####......#####.......#######....########....########...########.....##....................#
####.....###..............#####.....####.......####........######.....######...........##....#######....##########...######....#
####......................######....####........##.........#####.......#####..................######....####..#####...######...#
###......................#######.....###....................##..........####...................#####....###....#####......#...##
##........##............#######.........................................####....................####...####.....####..........##
##.......####...........###..............................................##............................####......####.........##
##......#####...........##....................####.....................................................####......####.........##
##......####...........###...................######.........#####......................##.##...........#####......###.........##
###......##............###...................######........#######........#######.....###.###..........#####......###.........##
####...........###......###.................########.......#######.....###########..#####.####..........#####......##.........##
####..........#####.....####............#############......#######....###################.####..........#####.................##
###..........######....######...........#############.......#######...###################..####.........######................##
###..........#####.....######............###...#######......#######...####.########.##......######.......######...............##
###....##....####......##..#.....................######....##############...######...........######.......######..............##
###...####...####.................................######################.....#####...........######........#####..............##
###...####...###...................................#####################......####...........#####.........#####..............##
###...###....##..........#.......####........###....############...#####.......###...........####...........###...............##
###...###...###..........##.....#####......#######.#####............####.......###..........####..............................##
##....##########.........#......#####.....#############..............###....................####..............................##
##....##########.................####.....############...............####....................####....###...............##.....##
##....##########..................###.....####...#####.....##........####....................####...####..............###.....##
##.....#####..............................###.....####....####.......#####..................#####....##.....##.........##.....##
##.....####..............................###.......##.....####........####.....###....###########..........####...............##
##.....####.......###......#.............###...............##..........###....####################.........#####..............##
##....#####......#####....###..........................................###....###########..#######.........#######...........###
###..#################....##...........................................####..###########......###...........#######..........###
###..############..####..###................................##........#################.......................########........##
##....##########....########................................###.......################.........................#########.....###
##........#####......######.................................##........#################.........................################
##..................................................#..................###########..####.........................###############
###................................................####.....................#####....####.............................##########
###................................................######....................####....#####.................................#####
####...............................................#######....................####...#####..................................####
####................................................#####..............##.....####....#####........######...................####
####..................##...............................................###....####.....####.....##########........####.....#####
####.................####.......................................##.....###.....###......###....###########.....########....#####
####.................####..........##....................##.....###....##......##.......###...###########.....#########.....####
###..................###...........###...###...........####.....####...##.....###.......###...###########.....#########......###
###..................###............###..###..........#####.....####...###....###............############......##..###........##
###..........###....#####............##..####........#####.....####....####....###..........#############......................#
####........##############...........##...####......#####.....#####.....####....####.......##############......................#
######......###############...###....##....##############....#####......####.....####....#################....................##
#######....#######################..###....##############...#######....######....#####..###################..................###
########..##############################..####################################..###############################..######..#######
################################################################################################################################
