################################################################################################################################
#################################..........................................................................................#####
####......#############..#####........###########.#############.........######...######.######....####..######.###########....##
###.......############....###.........##########...######................###......####...###......###....####...##########.....#
###.......#######.........###........##########....####............................###............###...........##########.....#
###........#####.........####........#########......#...............................##.............#............##########.....#
###......................###.........########.......................####........................................##########....##
###.....................###..........########.......................#####........................................#########...###
###.....................##............#######.......................#######...............##......................#######...####
##....###..............................######.......................########.............####.....................######...#####
#.....####...................##.........#####...............####....########............#####....................###.......#####
#......###.....###..........####........#####......#.......#####.....#######............#####..............##...###........#####
##.....###....#####.........####.........####.....##......######........................#####.............########..........####
##......##....#####........####..........####............####..................#........####.............#######....##.......###
##...........######........###...........#####...........###...........S......###........##..............#######...####......###
###.........######...##.................######...........###..................###.........................############......####
####........#####...####..............########...........####.............................................########..........####
######......####....####.............#########...........####............................................######..............###
#######.....####...####.........##....########...........####............................................#####...............###
########....####..####.........####....######......#....#####............................................#####................##
#########....###..###..........#####....####......###..######....................####.....................#####...............##
#########....###...............######...###.......###########...................#####......................#####..............##
########......#................######....#.........##########...................#####.......................####..............##
#####.##.......................#######..............##########..###....##........###.........##....##.........#...............##
####...##......................########.............################..####..................##########.............###...#...###
#####..........................########.............#######################...........###...###########...........########.#####
#####...........................######..............###########..##########...........###...###########...........########.#####
####.................######......######............###########....#####..#............#################............#######.#####
###.................########......######...........###########.....###................#################............#######..####
##..................#######........######...........##########.....###.................############................######....###
##...................###............#####.............#######......###..................####....##................#######....###
#...................................#####.....##......####.........###........#...................................######.....###
#...................................######...####......##..........###.......###..................................######.....###
#......##..........................######....####...................#........###....................................#####....###
##....###...####..................######.....####............................###......#.........#...####............######....##
########...#####..................#####.......##..............................#......##........###########..........#######...##
#######....####...................#####........................##....................##........############.........#######...##
#####.......##....................#########...................####.............................############.........#######...##
####...............................#########..................#####...........................#############..........#######.###
####...............................####..####..................#####.........................#############............##########
####...................##......#######....###...................####......#######...........#######....###.............#########
#####.................####....########.....#.....................####.....########.........#######......##.............#########
#####................#####....########...........................#####....#########......########.......###............#########
######..............######....#######............................######....########....##########........#######........########
#######.............######.......................................######.......#####...############.......########.......########
#######................##................................#........######.......####...####..######........###########....#######
#######..................................................###......######.......###....###...######...........#########..########
######.....................................................#......#######......###.....#....######............#############...##
######.....................................................####....######.....####...........####..............############...##
#######.....................................................####.....####....######....................##.......##########....##
#########...................................................####......##....########..................####.......######......###
##########..........................................###....#####......##....#########.................####......######.......###
##########..........................................###....#####.....##......#########...............#####....#######........###
###########.........................................##......#####...##.......##########.......##.....####....########........###
###########.................####..........#..................####..###........#########.....#####...#####....#######.........###
#...######...............############....###............##....##..#####........########....######...#####....######.........####
#....####...............#####...######..####...........####.......######..........#####....######....####...................####
#.....##.........##.....####.....##########............####......#######...........####...#######....###....................####
##...............##.....####........######..............##......########............##....#######...####.....................###
##..............###.....####.........###....................###########...................########.####.....................####
##.............###.....#####.........##....................#########......................#############.............#......#####
###...........####.....####.........##.....................#..####........................#############............###.....#####
####.........#####......##.........###.............###.....................................#############.........#####.....#####
######.......######................###............#####........................#####.......##############.......######......####
#######......#######................#.............#####.......................#######......###############......#####.......####
##########....######.......................###.....###........................########....################.......##.........####
###########....####........###............#####................##..............###########################..................####
############....##..........#.............#####...............####..............####################...##...................####
############..............................####................#####.......###......################........................#####
#####....##..........................#####.............#.....###..##.....#####......####...#####.............##...........######
####.............................#########............###....###..###...#######......##....####.............###...........######
####............................###########..........####....###...#############............##.............####............#..##
####............................#####..#####.........#####..###....######...####..................###.....####.................#
#######..........................###...######.......###########...######.....####................#####...#####.................#
########...............................#######......##########...######......####................############..................#
#########...................##........#########......########....#####.......####.................##########.....##...........##
#########..................####.......#########.......####........##.........####..................#########....#####.........##
#########..................####........#######........###.....................##............#......#########.....#####.........#
#########...........##.....####.........#####........####..................................##......##########.....####.........#
#########..........####.....##..........####.........####..........................................###########......#..........#
########..........#######...........#....###.........#####........................###...............####..#####...............##
########..........########.........###................#######....................#####...............##....#####.............###
########...###.........###............................#########..................######......................##..............###
#######...####..........###...........................##...#####..................######.....................................###
#######...####..........####.........................###....####....................####...##.................................##
########.######..........######.....................###.....#####....................###..###.................................##
##################.........#####....................###.....#####.........................###.................................##
###################.........#####...................##.....#######.........................###.........####..............##...##
###################.........##########....................########.......##................####......#######............####..##
##############...###.........##########..................########.....######.....###.......####.....#########.........######..##
#############.....###........################...........#########....#######....#####......###......##########.......######..###
############......####....###########..#######..........#########....#######....######.....###......##########......####.....###
############.......#################....#######..........##..#####..########....#######.....#......##########......###.......###
#############.......###############......#######..............###############...#######..........#####...###......###........###
#################....#############...........####..............##############...######..........#####.............##........####
##################.....######.................####..............########........#####..........###................##........####
#############..###.............................###..............######..........####..........###.................###.......####
##########......##...................#.#........##...............###.............##..........####.................###........###
#########...................##.......#.#.........##.........................................######............................##
#########..................####......##..........###.........###...........................#########..........................##
##########.................#####................####........#####...###.............#################.........................##
##########..................####...............####.......#######..####............#########.....#####.......................###
####..#####..................###...............####.......######...####......##....########.......####......................####
####...#####............................###.....##.........####....###.......###...####...........####........##............####
####...#####..........................#####.................##.....###.......###...###.............##........###............####
#####..####..........................#####..........##..............#........###...###.......................###.............###
#####...##..........###..........#########..........##......................#####.####........................................##
#####..............#####........##########..........##.....................###########.........................................#
####.............#######.......######..##.................................############.........................................#
###.............#########......#####...........#####.............##........#..########..................................E......#
##..............#########......#####..........#########.........####...........#######.........................................#
##...............#########.....#####...........##########.......####............####..........................................##
##.....................####.....####...............#######.......##........#....###..............###........###.....#......#####
#.......................####.....###................######................###...##..............####........####...###....######
#.......................####............##..........######.................##....#.............#####.........#########....######
#.......................###.............##...........#####.................##....##...........######.........#########....######
#......................####..............##.....##....#####................###..######........#######.........#######......#####
##.....................####..............###..#####....######.......##....#############.......########..........####........####
##....................######.............##########.....######......###...##########.#.......############....................###
###..................######..............#########.......#####.......###...#########........##############....................##
####.................####...............#########.........###........####...#########......###############.............##.....##
#####...###...........##................#########....................####....#########.....###############............####...###
#####...####...........................##########.....###............####....##########....###############............##########
####.....####..............##........#####################............##.....###########..#################...........##########
###.......######..........#######...######################...................###############################..........##########
###......###########......#################################.....####........#######################################..###########
####..################...############################################....#######################################################
################################################################################################################################
