################################################################################################################################
##############################.............................................................................................#####
################..########.......#######........###################.....##########...#######################...#########.....###
########...####.....................###..........###########..####.......########.....#####################......#######......##
#######.....##...................................######..##....###..........#####.....#########....#######........#####.......##
######...........................................#####.......................####.....########.....#######.........###........##
######.......................###.................###.........................####....########......###########...............###
#####.......................#####................##.........................#####....#######.....#############..........#..#####
#####.......................####...........................................#######...#######....#####...######.........###.#####
######......................###........................................############...#####.....####......###...........##.#####
#######.....................###.............................#..........#############...##.......###........................#####
########....................###............................###.........#####....####............##..........................####
###########................#####....###...................####..........###......####.......................................####
############..............##############................#######..........##.......###.......................................####
############..........##################................########.........###......###......................................#####
####..#####...........##################...................#####.........###.....####......###.....................#.......#####
###....####............################.....................###...........##.....####.....#####...................###...##.#####
##.....####...............######...####.....................##............###.....##.....######...................########.#####
##.....####................####.....###....................###...........####............#####.....................#######.#####
##......####.........................###..................####...........####............##........#######.........#######.#####
##.......####........................###.................#####..........#####....................##########.........##.....#####
##.......####.......................####.......#####.....####..........#####....................############...............#####
##........##............#...........####......#######.....##...........###.....................######...####.....#..........####
##.....................###..........####......#######..................##.......................####....####....###.........####
##.....................####.........####......#######..................#.................................###....####.......#####
###.....................###.....##.######....########.................##...............##................####....###.....#.#####
###......................###....##########...########.................##..............####...............#####....###..###.#####
##...#####...............###......########....#######........###......##............######....#..........######...########.#####
#...#########...........#####......#######.....######........###....................#######..###........########.#########.#####
#...#########..........#######......#####......#####.........###....................############.......###################..####
#...######.............########......###.......####...................................#########.......#####...###########....###
#....####..............########................###.....................................#######........#####....#########.....###
##...####...............#######................##......................................######..........####.....###..###.....###
###..#####...............#####................###.......................................#####...........###...........##.....###
###...######..............###...............#####.......................................#####.........................##.....###
##.....######..............................######.......................................#####........................###......##
##......######........#....................#####........................................#####.........................#.......##
##.......#####..###..###....................##...........................................###...........##..##................###
##.......####...########...........................##.................................................########...............###
###......####...#######.................#.........###.............###.................................#########..............###
####.....####....######........#.......###.......###.............##########............................##..####.............####
####......##......####........###......###.......##..............##########....####.........................##....#####.....####
####...............###..................#........###.###..........#########....####..........##...................######.....###
###.................##...........................#######...........#######....####..........####....................###.......##
##..................###..........................#######............######....###........###########.................##.......##
##...................####.......................######..............######....###.......#############................##.......##
##....................####......................####...............#######....####.......#############..............###.......##
##.....................###.....................####...............########....#####...............####..............###.......##
##......................###....................###................#######......######..............###.............#####......##
###.....................###......###...............................####........#######.............###.............#####.....###
####.............###.....#......########............................##..........##..#.............###..............#####.....###
#####...###.....#####..........##########..................###....................................##................###......###
###########....######..........###########.................###...............................######...........##.............###
##..#######...######...........#############................#................................####............####............###
#....#######..#####.............#############.................................................###.............####......#.....##
#....#######..####...............############.........................................##......###.............#####....###....##
#....######....###.....###........##########..........................###............####.....###............######....###....##
#....######.....##....#####.......#########..................###.....####.............##.......###....##.....#####.....###....##
##...#####......##....######......#########.................####.....####.......##..............###..####....###.......###.#..##
###...###......####...######.......########..............######......####......####.............#########..............###.#####
###...........#####..######........########.............######........##......######............#########..............###.#####
####.........#####...####..........########............######................#######............########................##.#.###
####.........####.....##...........#######.......##....#####................#########...........####..........................##
####..........##..................####..........####....###................##########............##...........................##
####...........................######...........####.....................######...####...................................#...###
####..........................######.............###....................######.....###..................................##..####
####.................##.......######........##..........................######..................###......................#.#####
#####...............####.......####........####...............##.........####..................#####........................####
#########...........####...................####..............####........####.................######.........................###
##########..........####....#...............##...............#####........##.................######..........................###
##########.........####....###..###..........................#####...........................#####.......#...................###
#########.........####.....##########.......................#####..................##.......#####.......###..................###
####.............####.......##########......................####..................####...#######........###..................###
####.............###.........##########.....................###...................####..#####...........###...................##
####.............###..........###..####.....................###....................##...###.............###....................#
###........##.....##..........###...##......................###.........................................###....................#
##......######....###.........###...........................###.........................................##....................##
##....#########....#..........##................##..........##.........................................###..............##.#####
##...##########.............................#########.......##.........................................###............####.#####
#....####...##.............................###########.....###........................................####...........#####.#####
#....###..................................#############..#####......................##...............####...........######.#####
##...###...................................####################....................###...............###........##########.#####
##...###.........##..............................##############..................#####.........................###########...###
##...###........####..............................############................######..........................###########.....##
#...............####...................................####..................######..........................############.....##
#...............####........................................................######.................####......#############....##
#...............####...##......................................###..........######................######.....#######..####.....#
##.............#########......................................####.........######.................######.....######....###.....#
##.............#########....##................................####........#####.............##.....####.....#######.....###....#
##............###########..####...............................###.........####.............######..........####..###.....#.....#
##...........##################................................##.........####......###...########.........###....####.........#
##..........##################.................................##.........####.....####...#########.........#......####.......##
#...........##################.................................###.........##......###.....########................####......###
#................#####....#####..........##....................###..................#..........###.................####.....####
##.........................####........#####..........###......###..................................####...........####.....####
####........................##.........####..........#####.....##......................####........######..........####......###
#####..................................##............#####.............................####........######..........#####.....###
#####...........#.....................................###..............................####........#####............#####...####
####...........###.....................................................................###...................##......###########
###............###......................................................................#...................####......##########
##.............####.............................................#....................................#......####............####
###..##........#####...........................................###.............##....................##......##..............###
########........#####....#.....................................#######........####...................#.......................###
########........#####...##########.............................##..............###........##.................................###
########........#####...###########...........................##########........###......####.....................##.........###
#########.......#####....##########..........................###########........######..######...................####........###
###########.....#####..........###...........................#####...............#############...................####........###
###########......####........................................####.................############...................###..........##
########...........#..............................###........####.....................#######............##.....####..........##
#######..................................###.....#####......#####.....................####......##......##.....####............#
###.........................###.......#######....######....#####..........##..........###......####...........####.............#
###..................###...#####.....########.....#####...#####..........####.........###....#######..........###..............#
###.................####...#####.....#########......##.....###.........#########.....####...#########.........###..............#
###..................###....####.....#####..####......................###########...#################.....................##..##
##...........................###.....####....####....................############...##################...................#######
##...........................####....###.....#####................###############...##################...................#######
##............................##.....###.....#####...............##########..####...#########...#####.....................######
##..................................####.....#####...............#########....###..#######.......###......##.................###
###.................................####......###.................#######..........######.........#.......##..................##
###..................................###...........................................#####......................................##
###..................................###............................................####.....................................###
##........##.........................##.......................##....................####.....................................###
#.........###.........####...........##......................####...................####.....................................###
#.........###....##..######..........###..........##.........####...................####....#.......###.......................##
#.........####..############..##....#######......####.......#####............##....######..###......####......................##
##.......###################################....######...########..........#####..#############....#######.............####..###
##################################################################......########################################################
################################################################################################################################
