################################################################################################################################
##########..###################.....############################################################################################
#########.......#########..##........#############################....######.....#####....######################################
########.........####................################..####...###........###......###......#####################################
#######..........###................#####..#########......................##...............################################..###
####..............#................####.......######......................###...............##############################....##
###................................###.........#####......................######.............#############################....##
###................................###.........#####.......................#####..............############################....##
###......#..........................###........#####.........................###..............#######################..####...##
##......###................###.......####......####...........................................######################....###...##
##.....####...............#####.......####......##.................##..................#######...#################.......#...###
##....#####.............#######.........###...........#..........####..................#######....###############............###
##....####.............########.........####.........###........#####......##..........######.....###############.............##
##...#####............#########.........####........###.........#####.....####..........####.....#########..######.............#
##...#####............#########.......#####....########..........#####...#####...........###.....########....######............#
##########.............########......#####....##########..........###########............###......######......######..........##
##########..............######.......####.....###########..........#######...............###........###.........####.........###
#########..................##.......####.......###########............###...............###......................###.........###
#####...............................###...........#######...............................##....####................#...........##
####................................##.............####......................................######................#..........##
###................................###..............##.......................................######........#......####.......###
##..................................#.........................................................####.........#.....######.....####
#....................##...###..............###.............................................................#.....######....#####
#...................####..###..........#######...........................##......................................#####....######
#....................###...##.........########...........................###............#.........................####....######
#....................................########...................###.......###..........###.........................###....######
##...................................######....................####.......###.....................######.....#.......#.....#####
###...................................####...................#####.........###....................######...#.##......#.......###
####..........##.........###...........##...................#####...........#.....................#####....#.##......#........##
#####..##.....###.......######.............................#####...................................##........#......###........#
#########.....##........#######............................####.....................................................###........#
########.................#####.........................................................##............................##........#
########.................####..........................................................###....................................##
########.................###...........................................................####...............................######
#########...............####...............###...............###.......................####..............................#######
#...######..............####..............#####..............####.....................####............................##########
#....#####...............##................####..............###......................###............##......#.......###########
#.....###...................................##...................................#..................####....###......###########
##...............................................................................##................#####....####.....###########
###...............####...............................................###.........#.................####.....####...........#####
####..............#####.........................#.................#######...........................##......###.............####
####..............######..............##.......###...##.....#....########............###...................####..............###
#####..............#####............####......##########...##....#######......##....#####.................#####...............##
######..............###..........#######......##########....#....#####.......####...#####.................#####...............##
#######.........................#########......########..........####........####...####...................####...............##
#######.....##..................##########......######...........####........#####...##....................#####..............##
###..#......##..................####..####.......####.............##.........######.........##..............####..............##
##..........##.....#.............##....###..................................########.......####.............#####............###
##.................#....................##....................###...........####.###......#####.............#####............###
##........................................................#######...........###...###......####.......###...####.............###
##....##.....#...........................................#######...........####....##.......####.....#####...##...............##
###..####....##.............................###.........######............#####................###########.....................#
#########............................##.....###.........#####......##....#####..................##########.....................#
#########......................###..####.....##..........####.....####..#####.....................#######......................#
#########.....................##########.................#####...############......................#####..................##..##
#####..#......................#########...................####..#############..................#..#####......#............######
###............................######.....................####..#############.................#########.....###...###.....######
##........................................................###....############....##...........########....#####..#####......####
##...................................................................#######....####...........######....#####...#####.......###
##...............###.................................................#######.....#######.........###.....####....#####........##
###.............#####.......###......................................#######......######..................###....####.........##
####.............####.......###########.....#...................############...............................###...###.........###
#####.........................##########...######..............##############..............................####..###.........###
######..........................########...#######............################..............##............#####..####........###
######...........................######....#######............################...........######..........#####...#####.......###
######............................#####.....#####.............################..........#######.........#######.######......####
#####...................###.......#####.......##..............####..##########.........########.......###############......#####
####...................####.......#####.................##....###....#########........#########.......##############......######
###....................####......######................####..........########.........##########......#############.......######
###..............##...#####.....#######................####..........##..............###########.............######......#######
###.......###...##########.....########.................####.......................#####....####..............#####......#######
###......####...##########.....#########................####......................#####......###........................########
##.......####....#########.....#########................####......................#####......##........................#####...#
##......####......##...###.....########.................####....##................#####.....###...........#............#####...#
##.....####.....................######...................##....###.................###.....####..........###............###....#
##.....###.......................####..........................####................###.....####..........####...##.............#
##.....###........................###...........................######..............##......##...........##########...........##
###...####......................................##...............#####......................##...........#########.........#####
##########.....................................####...............####.....................###...........#######..........######
#########......................................####........................................####...........####...........#######
########........................................##.........................................####..........................#######
###..##.....................................................................................##...................#........######
##...........##.............................##..................................................................###.........####
#..........#####...........................####.................................................................###..........###
#.........#######......................#######..................................................................###..........###
##........#########.........##........#######...##.....................................##.......................###.........####
####......###########.......###.......############......####..........................####......................###.........####
#####......##########.......###.......##########.......#####..............####........####......................###.........####
####..........#######.......####......#########.......#####...............######......#####......................###.........###
###............####.........######....#########....#######................#######....######................#......##.........###
##.............###...........#######..########.....######......................###########........................###........###
#..............###...........###############.......#####........................#######............................#........####
#...............###..........##############..........###........................######......................................####
##....#####.....######........#############...........###.......................######......................................####
##...#######....#######...........##########...........###..........#...........######.................................##..#####
##...#######...########............#########............###........###...........####.........##...............#......##########
##...##################............######...............###.......####............##.........####.....................##########
##...###################..........#####.................####......####.......##..............#####.........##..........#########
##....###################.........####...................####....####.......####........###...#####........##..........#########
##....####.##############........#####....................###....####.......#####......#####....####.......###..........########
##....###...##########..........#####.....................###....#####.......####.......#####....####......###...........#######
###..####....########...........###.......................####...######.......###........#####...####......####..........#######
#########.....#######..........###........###............#####...#######..................###.....###.....#####....##...########
########.......#####......########.......##########.....######...#######.............##...................#####....#############
###.............####......########....#############.....######...######.............####...................#####.....###########
###..............##.......########...##############......#####...#####..........#...#####....................####.....##########
####.....................########....######...............#####.####...........###...#####....................####.........#####
####....................###...........###..................########............####...####....................####.........#####
####...................##########...........................#######.............##.....###....................###.........######
####..................###########...........................#######.......##...........###.....................#.........#######
####..................###########..............#.............#####.......####.........###...............................########
#####.................############............###.............###........#######.....####...............................########
#######................############......###..###.......................##########..####..............###...............########
###########............##########################.......................################..........########..............########
###..#######.....##.....##...####################.......................####..##########.........#########..............########
##....#######...####..........###################.......................###....#########........#########................#######
##....#######...####...........###......#########.......................###.....########.......########......###...........#####
##....######....###......................########.......................###.......######....########.........#######........####
##....####................................########......##.........................######..########..........########.......####
###...............................##........#######....####.........................##############.............###########..####
###..............................#######.....#######..#####...........................###########...............################
###..............................#######......############..............................########.................####...########
###......##.......................######.........########..........####..................######..........................#######
####....####.....................................#######......###########.........##.....######...........###.............######
##################...##.......................##########.....#############.......#####..#######..........####................###
#########################...............#################...##############......################..############..##............##
#############################..####....####################################....######################################..#####.###
################################################################################################################################
