################################################################################################################################
##....................................................................................##############...#################..######
##.#....########.....#######....######..##########.###############################...........####.......#####.......###.....####
##.#.....#####..........###......###.....######.....##################.#####..###.......................####.................###
##.#......###............##.................##......#####..##########...###.............................####..................##
##.#.....................##.........................####....#########....#...............................##...................##
##.#.#...............................................##......########.............##.....###....##..................###.......##
##.#.##..........................................................####.............##.....####.......................####......##
##....#####.......................................................##..............##......####.......................###......##
#.....######...............................................................................####..............................###
#.....######................................................................................###...............###............###
#.....######......................##..........###............................................................#####...........###
##...########.....................###........#####..........###.............#..........................##....#####...........###
##...########.....................####.......#####.........#####...........###........................####...######...........##
##...########.....................####........#####.....#######...........####...........###..###.....####...#######..........##
##....###..##.....................####.........####.....#####............#####..........##########.....##.....########........##
##.................................###..........##......###........##....#####.........############.............#######.......##
##.................................###............................####....#######....###############.............#######......##
#................#................#####...........................####.....#######..################..............######......##
#..........##..####..............######.............###..........#####......#####..########..#######.............#######......##
#.........########...............#####.............#####.........#####......####...########...######............########.....###
#.......##########................###.............######..........####......####...#####......#######..........#########....####
#......#######.##.................................#####...........###.......#####.######.....########.....##...#########....####
##.....######......................................##........................###########....#########....####...#########...####
##....#######................................................................###########...##########....####....########....###
##.#.########.............##.............##.................................###########...##########.....####.........##......##
##.#.#######..............####..........####.................###...........#######........########........##..................##
##.#.#####.................######....#######................#####.......#########..........######.............................##
##.#.####...................#################...............#####......##########...........####.............................###
##.#.#.......................#################...............###......###########...........####............................####
##.#.#......###..............#################.......................############............##.......####.................#####
##.#.##....####..............################........###.............###########......................#########.....##.....#####
##.#.##########...............############..........#####.................#####.......................##########...###......####
##.#.#########....#..............#######............#####..................###.........................###############........##
##.#.#####.......###..............#####.............#####..............................................##############..........#
##.#.##..........####.............#####......##......####........####.................................##############...........#
##.#.#...........####......##....#######...#####.....####........#####........................###..#########..######...........#
##.#..........#.#####......####################......####........#####.......................#########.........#####...........#
##.#.........########......##################.........##.........#####.....#####............#####..##..........####...........##
##...........########..........###...#######.....................####.....######...........#####...............####...........##
##...........#######...................####.......................##......######...........####.................##............##
##............######....................###................................###..............###..........##..........######...##
##............######....................###..................................................#..........####........#######...##
##.#..........######....................###....................###......................................#####.......#######...##
##.#.........#######...................#####.........##.......#####..........#####.....................#######......#######...##
##.#.........######.....###..........############....####.....####..........######.....................#########....######....##
##.#..........#####....####.........##############...#####....####.........#######.....................##########...######....##
##.............###.....####........#####..########...######...###..........######..........#......#....###########...#####....##
##..............##......####.......####.....#####.....####.....##..........####...........###....###...############.....###..###
##..............##.......####.......##.........................###..........##............###....###...#############.....#######
##...............#........####..................................##.......................###....####...##############.....######
#..........................####.................................##.......................##....#####...###############.....#####
#...........................####...............................###............................######....##############.......###
#............................####.............................###......###...................#######....#########...#.........##
#..............................#.......##....................###.......####..................#######.....#######..............##
#......................................###....................#........#####.................#######..........................##
#.......................................#..............................#####................########......................######
##.....................................................................#####................#########....................#######
##......................#.............................................######........#......###########...................#######
##................#....###.............................###......##....#####........###.....###########...................#######
##...............###....###....##................##########....####....#..........####......#########.....................#.####
##......................###...####..............############...#####............######.......###..##.........................###
##.......................#....####.............#############...#####..........#######........................................###
##.............................##..............############.....#####........#######...............................##.......####
##..............................................######...........##################.........................##....####.....#####
##.......#..............##........................###.............##############.....................#########....####....######
#.......###............###.........................................############................#....##########.....##....#######
#.......####...##.....####..........................................######....................###....##..###............########
#.......##########...####...........................................#####.....................###.......................########
##......##########..#####.......####..................#######........####...##...............####........................#######
##......#########..#####.......######................########.........##...####.............#####...........................####
##.#....######.....####........#######...............#######...............####.............######..........................####
##.#....#####......###..........#########............######................####.............######..........................####
##.#...#####.......................#######..........########..............####..................#...........................####
##.#.######.........................#######.........#########............####.........###...............#....#.............#####
##...######..........................######........####..#####....##########.........#####..............#.................######
#....#######..........................####.........###....################...........#####................................######
#.....######.............#.........##.............###......##############.............###..................................#####
##....######............###.......####..........####..........###########....................................................###
##....#####.............###.......#####........####............##########...................#######..........................###
###..#####..............###.......######........##.........##..###########................##########.................##......###
####.####..............#####.......######.................################...............############...............####....####
####.##...............######........#####..........##......##############................############.....##........####...#####
####.#................#####..........#####........####........#########..................###########.....####........##...######
####..........##.......##.............#####.......#####........#######...................#####............###.............######
####.....##..####.....................#####......#######.......######....................####..............##..............#####
####...####..####.....................#####......######.......######....................#####..............##...............####
####.######...##.....................#####.......###..........#####.....................#####.........##..####...............###
####.######.........................#####.......###.....#.....#####...............#......###.........#########......#####....###
####.#####.........................#####.......####.....##.....####.............###..................#########.....#######...###
###..###..................####....#####........####.....#......#####...........###...................#########....#######....###
##........##.............#####...#####.........####............####.............#........##..........##########...######......##
##.......####...........######...#####..........##............#####.....................####........###########....####........#
##.......######........####......#####........................####......................####.......###########......##.........#
##.......#########.....###.......#####.......................######......................##.......############.................#
##.......##########....###.......#####.......................#######.............#..............#########..###.................#
###......##########.....###.....#####........................#######...........................####...##....###................#
###.......##########.....###...######.........................##...............................###...........####..............#
###........#########......############..........................................................#............####..............#
####...........#####......##############....##................................................................###..............#
####............####......#######.....#########................................................................................#
####.............####.....######.......########.............##.........................................##......................#
####.............#####....######.........#####.............####........##.............................####.....................#
####.............######..######.............................###........###........................#######......................#
###...............###########................................#.......#.##.........................######..................##...#
##......................####....##...................................#.##.........................#####..................####.##
##........#....................####..................................#.#............................###..................#######
##.......###..................#####..................................#.#.............................###................########
###..##...###...........#.....####..................................##.#..............................#####.......###..#########
####.###..####..........##.....##................................#####.#..............................#########..########.....##
####.###########........#..............................##.......#######................................#################.......#
####.############.....................................####.....#######..................................##############.........#
####.#############....................................####.....######....................................############.........##
####...###########....##..............................####.....#####.......................................###..#####.........##
###....###########...####..............................##......####..............................................####.........##
##.....##########....####...###.................................##..............................###....##........####.........##
##...##########......####...###...............##........................##......................##########.......###.........###
#...##########........##...####.....................................#######......##.....###.....###########..................###
#...##########............######..............##...............##..#######.......##.....###.........#######..................###
#...##########............######..............................############..............###..........######..................###
##...##########............######.............................###########..............####...........######.................###
##...###############........######............................###########..............####...........######..................##
##....##############........######............................############..............##............#####...................##
##....###############.......#####......###...........##.......#############..........................#####.....######.........##
###..####################..#####.....######.........####..##################........................#####....#########.......###
################################....########.......###################################.........###########..###########....#####
########################################################################################..######################################
################################################################################################################################
