################################################################################################################################
########............####################...####..#####..#################....##########..#######################################
########....####..............########......##.............###..######...................#####....#####..############........###
########.......................######............................###....................#####.....####....##########..........##
###..###......................######...................................................#####......####.....###................##
##...........................#######......................................##...........#####......#####.......................##
##..........................#######......................................####...........###.......#####......................###
###..........................###.......#.................................####......................###.................#########
######................................###....................##.........#####..........................................#########
#######................................#.......#.....####...###.......#######.............................#########....#########
#######..................##...................###...##########........######.............................###########....##...###
######..................###..S...............####...#########............................................###########.........###
#####..............########...............#######....#####.....................###.........###.....###...##########.........####
###...............#######.................######...............................###.........####....###....########..........####
##.........##....######........#..........####................................#####.........##.....###....########..........####
##.......#############.......####.........###.....###.......##..........############..............####.....#######....##....####
##.....#.############.......####..........###....####......####.........############.............#####.....######....####..#####
##.....#.###########.......#####...........###..#####......####.........############............#######.....###.......##########
##.....#.######............######..........#########.......####...#.......######................########...............#########
##.....#.#####.............########........########.........##....##.......#####.......##........########...............####.###
##....##.#####.......###....########........######................#.........####......####........########....................##
###..###.#####........#.......######........#####............................####.....####..##.......#####..........##.......###
########.######...............#####........#####..............................####....###..###........####.........####....#####
########..######..............#####.......#####.......###.....................#####...###..###.........##...........####..######
#######....#####.............#######.....######.......###......#...............####...###...#.......................############
######.....####..............##################...............###..............####...###...........................############
#####......####..............#################.................##..............###.........................#.......######..#####
#####......####...................#########....................###.............###..................###...###.....######....####
#####......####....................#######......................##............###...................###...###.....#####.....####
######......###.....................#####.......................###...........###.................................####......####
######......####......................##........................###...........####................................###.......####
######.....#####................................................###............##................................####........###
######....#######..........................##....................##..............................................#####........##
#####....##############...................####...................##...............................................####........##
###......################.................#####............##...........................##....................##..............##
##......##################.........###....#####...........####.........................####..................####.............##
##......###################........###....####............####.........................###...........#........####...........###
##......###################.......#####....###......##.....##............####...........#...........###.......######........####
##......#########......####.......#####.....#......####.................#######.........#..........####......########......#####
##.....#########.......###.......#####.............#####........#####..#########.......###.........####.....#########.....######
###..###########................#####...............####.......#################......####........#####....##########....#######
###########..###...............#####..................#........######..#########.....#####........######..................######
##########.....................######..........................##.......##...##.......##..........#################.......######
##########......................#####..............................................................############............#####
####..###.......................................................................##.................###########..............####
###...................................................................##........###.................#########................###
##.................................................#........##.......#####......####..........................................##
#..................................###............###......####.....########...######.........................................##
#................................######.....###...####.....####.....##################........................##..............##
#...............................################.#####......####.....#################.......................####.............##
#...............................#####################........####....#############..##.......................#####............##
##...............................####...#############.........###....############...........................#######...........##
###...............................##.....###...######.........###....###...#####...........................#########...###....##
###....................#........................######........###....###...####...........................#################....#
##....................###........................#####........###....###....##...........................######.....#######....#
##....................###............#............####........####....#..................................###.........#####....##
##.....................##...........###.....###....###.......#####................#...................................###.....##
##...###....##.........###.........####...######...###.......####.................##.........................................###
#########..###..........##........##############...####......##...................#...........##.............................###
##############...................###############...####......................................####......................###..####
#############....................###############....##.......................................####.........##...........#########
############.....................##############...............................................##.........####..........#########
###########.....###.............#####..#######.............................#............................#####...........########
##########.....######.........######....##................................###..........###............#######...........########
##########.....########.....########.......................................#.........######....#......########..........########
##########.....#########...#########................................................#######...###.....###########........#######
##########......#####################.............................................#########...####........########........######
##########.......###############..##..............#.....##........................#########...#####........########..........###
##########...........#########...................###...####...............###..........####....####........########...........##
####..###................####....................###...####....##........#####..........####...####.........######...........###
####.............................................###....###...######.....#####....###....##.....####.........####.......E...####
####....................................................###...#######....#####...#####..........####.......................#####
####.........##................#............##..........####...#######..######..######..........###......................#######
#####.......###...............###..........####.........####...###############..######.........####.....................########
######....####.................#...........####....##..#####....##############..#####..........###.....#..................######
######...........####................#.....####...##########....#####################..........####...###..............#########
######..........#####...............###.....##....##########....########...##########...........####...#...............#########
#####...........####................###.....#.....##########....#######.....#########............####.........##..........######
#####................................#.....##......########......#####......##########............####.......####.........######
####..............................................................###......###..#######............#####......###.........######
###...............................................................###.....###....#######............#####.....###........#######
##...............####.....##.................................##..####....####....#########..........######....###........##..###
#...............######..######..............................##########..####.....#########.........#######....###.......##....##
#.......###....##################..........................###########...##.....##########........########....###.............##
##......####...##################.......................#############..........##########.........########....####............##
####....####...##################......................#############...........#######.............#######....#####...........##
#####...####....#######..#######.......................#############...........#####.........#.....######......#####..........##
#####...####.....#####.....####........................############.............###.........###...######...........#.........###
#####...####.....#####.....####.......................####....####..............###.........############.................#######
#####...####.....#####......###.....###..............####......###...............#..........#############................#######
#####...####....#####......#####...#####............#####.......###.........................##############...............#######
#####...####....#####.....###############..........######........######.....................##############...................###
####.....##.....####......###############.........#######.........#####..............###....#####..######.....................##
###..............##............#########.........########.........#####..............####...####...####.......................##
##..............................####............#########..........###........###.....###....##.....##........................##
##.............................................###########..#####............#####.............................##............###
##............................................####################...........######...........................###...........####
##........................................#########################..........######............##............###............####
##........................................##########################..........#####...........####..........####.............###
###................................###.........#####################..........####............#####.........####..............##
####..............................#####...........##################...........##...###......######.........####..............##
#####............................########..........################................##################.........#..............###
######..........................##########.........###############....##...........###################.......................###
#######.........................###########.........#############....####...........##################......................####
########........................###########.................####....####......#......##################................#########
#########.......................###########..................##....#####......###.....#################..............###########
#############...................##########.........................#####.......###....################...............###########
#############...................#####...............................#####.......#.....#############...................##########
###....#####....................####....................##..........######.............####.....##.............##......#####.###
##......####.....................##.........##..........###.........#######............###...................#######..#####...##
#........###..........##.........##........####.........###........###..####...........###................################....##
#........###.........####........##.....########.........##.......###....####..........###................################....##
#.......####........#####........###...##########.................###....####.........###.................######...#######.....#
#.......####.......#######........###..###########................###...#####........###...................####.....######.....#
##......###........#######.#......###...##########......................####........####....................##.......####......#
###................#######.##.....###...##########........###...........###........#####.......................................#
#####..............#######.##.....###....##..............#####..........###.......#######......................................#
######........##...#######.#.............................######..........##........########............##......................#
######.......####...####..................................#####......................#######..........###.....................##
######......######.........................................####.......##..............######...........##.......####..........##
######....##########..........................##............##.......####................##.....................#####........###
#####....############........................####....................####........................##.............######......####
###......############.......................######....................##.........####.....#.....####...............####.....####
##.......###########........................#######........................###..#######..###....#####...............####.....###
##......###########........................#########......................##################....#####...............####.....###
###....#############...............##......##########.....###.............###################..#######.....##..##########...####
######################################....########################.......#######################################################
################################################################################################################################
