################################################################################################################################
################..##..###..####...######......##########....##...####################################....#######################
###...###...................##......................###.......................###......############.......#######.......##...###
###.....................................................................................###...##..........######..............##
###........................................................................................................#####..............##
###...........................................................................................................................##
###.............###..........................................................................................................###
##.............#####............................................................................#............................###
##..............###............................#...........................................#######..........................####
###...........................................###..........#...............................#######...........................###
###............................##..........#####..........###..............................######.............................##
###...........................###.........#####...........###................................####..............................#
###............................#.........#####.............##.................................####.............................#
##.......................................####..............##..................................###.................##.........##
##........................................##..............##....................................#..................###........##
##....................................................######........................................................#.........##
###..................................................#######..................................................................##
###..................................................#######............###...................................................##
###..................................................######............#####.................................###..............##
###...................................................##................###......................#...........###...............#
###............##...............................................................................###...........#................#
###............###...............................................................................##...........................##
###............####.....................#####....................................................###..........................##
###.............####...................#######...................................................####.........................##
###..............####..................#######....................................................##..........................##
##..............#####...................#####..............###.................................................................#
##.............#####.......................................###.................................................................#
##............#####.........................................##.................................................................#
###.....#......###.............................................................................................................#
###....###.....................................................................................................................#
##......................................................##.....................................................................#
##.......................................................#.............##..................................##..................#
##..............................###...................................###..................................###................##
##......................#.......###..................................###...................................###................##
##......................##..........................................###.....................................###................#
#................#..................................................###.....................................###................#
#...............##.................................................###........................................................##
#....................................................#............###.........................................................##
##................................#..............................###..........................................................##
##...............................................................###..........................................................##
##..............................................................###...........................................................##
##..............................................................###..............................###..........................##
##...............................................................#...............................####........................###
##............................................#..................................................####........................###
##...........................................###..................................................###........................###
##...........................................###..............................................................................##
##.............................................................................................................................#
##.............................................................................##..............................................#
##...........................................................................................##...............................##
##...........................................................................................##.............##...............###
##...........#...............................................................................##............###...............###
##.....#....###.............................................................................####...........##.................##
##....###....##.............................................................................#####.........##..................##
#.....###....................................................................................#####............................##
#.....................................##......................................................#####...........................##
#....................................####....................................#..................####..........................##
##...................................####....................................#...................###..........................##
##....................................##......................................................................................##
##............................................................................................................................##
###..................................................................................................................#........##
####...............................###...............................................................................#........##
####..............................#####.......................................................................................##
###...............................#####.......................................................................................##
##.................................###.......................................##...............................................##
##.......................................................................................................................#....##
#........................................................................................................................##...##
#.............................................................................................................................##
#.............................................................................................................................##
##...........................................................................................................................###
##...........................................................................................................................###
##............................................................................................................................##
##.............................................................................................................................#
##....................#........................................................................................................#
###...........................................................................................................................##
###.......................................................................................#.................###...............##
##.......................................................................................###................###................#
##......................................................................................####...............####................#
##......................................................................................####...............####...............##
##.......................................................................................##.................####..............##
##..........................................................................................................#####.............##
##..........................................................................................................#####.............##
#...............................###..........................................................................####.............##
#................................#.............................................................................###............##
#.....................................##.....................................................#..................#.............##
##....................................#.......................................................................................##
###..........................................................................................................................###
###.........................................................................................................................####
###........................................................................................................................#####
##..........................................................................................................................####
##..........................................##..............................................................................####
##..........................................##...............................................................................###
##..........................................##................................................................................##
##............................................................................................................................##
##............................................................................................................................##
##............................................................................................................................##
##........................................##...................................................................................#
##........................................##...................................................................................#
##........................................##...................................................................................#
##.......................................###...................................................................................#
##......................................####.....................................##........##.................................##
##.....................................#####....................................#####.....###.................................##
##...............................#....#####.....................................######....###.................................##
##..............................##....#####......................................#####....##..................................##
###...................................####.......................................#####........................................##
###....................................##........................................####.........................................##
##................................................................................##..........................................##
##....................................................................................................##............#.........##
##..........................................................##........................................##...........###........##
##..........................................................###.......................................##...........##.........##
##..........................................................###...............................................................##
##..........................................................###...............................................................##
##............................................................................................................................##
##..................##........................................................................................................##
##..................###.......................................................................................................##
##..................###.......................................................................................................##
#........................................##...................................................................................##
#........................................##...................................................................................##
#.....................................................................................................##......................##
##..................................................................................................#####.....................##
##.................................................................................................#####.......................#
#.................................................................................................#####........................#
#...............................................................................................######.........................#
#..........................................................................................###.######..........................#
##.........................................................................................#########..........................##
######......###..................................................................##........#######............................##
########...####.................................###..................##..........###.......#######............................##
################.....######..########.......########..##...........#####........########..##########################.........###
################################################################################################################################
