################################################################################################################################
########.....................................#######################..###########..###############################........######
##.####........................###............####...........#####........###.......#######..################...............####
#...###........................###.............##..............##.....................####....####..########.................###
#....##.........................##.............##......................................###...........######..................###
#................................#####.........##......................................###...........######..................###
#.................................#####........##......................................####...........#####...................##
##................................######.......###....................................######..................................##
##...............................########......####...............................###########.................................##
##..............##..........##############......###..............................#######..##..................................##
###............####........#######.....###......##...............................#####........................................##
###.............####.......#...................###..............................####..........................................##
##...............##.........####........###..#####...........##................####...........................................##
##..........##..............####........##########..........####.............######...........................................##
###.........###..............##.........###############....######............#####............................................##
####........####........................###############################......####.........................####................##
#####.......####........................#######..#############...#######..................................######..............##
#####......#####.....##.................######....##.....####.....######...................................######.............##
###...##..#####.....####.................####.............###.....#####.....................................####...............#
##...########.......####..................................###.....#####......................................##................#
##...#######.........##..................................####.....#####........................................................#
###.########..........................................#######.....######.......................................................#
###.#######..........................................#######......######.......................................................#
##...#####....................................##.....######........####........................................................#
##....###.....###............................####.....####.....................................................####............#
##............###.............................###......##.....................................................######..........##
#............####....................................................................##.......................######..........##
#............####....................................................................###.......................####...........##
#.............###....................................................................##.............................#.........##
##............###...................................................................................................##........##
##............###........##........................................................................................###........##
#............####.......####....................###........................................##.................................##
#............####.......####...................####....................................#######................................##
##............###.......####...................####...................................#######................................###
##.......................##.....................##....................................####..................................####
##..........................................................................................................................####
##...........................................................................................................................###
#.........................................................###....................................................###.........###
#...................................#....................#####..................................................#####........###
##.................................###...................#####...##.............................................######......####
##..................................#....................####....##..............................................#..###.....####
##........................................................##.....###.................................................##......###
##...............................................................###.........####.............................................##
##........................#####.............................................######............................................##
##.......................#######..........................................#########...................######..##.............###
##........................######..##.....................................####..####...................##########............####
##.........................####..###.....................................###....##.....................#########............####
##...............................###.....................................###.................................................###
###..............................###....................................###...................................................##
###..............................###..................................####....................................................##
###.........................#....###..................................###......#.............................................###
###........................###..#####.................................##......###..........................................#####
###.............##.............#######........................................###.......................##................######
##.............####............########.......................................####..............##......##................######
##............####..............########.....................................#####.............####.....##................######
##............###................#######..................................#########............####.......................######
###...........##..................######..................................##########............##.......................#######
###...........##...................####...................................##########....................................########
###...........###.........................................................##########....................................########
##............###.........................................................#########......................................#######
##............###........................................................##########........................................#####
#....####....####.......................................................###########..........................................###
#...######...###...................###...............................##############...........................................##
#...######....................#....####..............................##############..........................###..............##
##..#######..........###.....###....####.............................##############........................######..............#
##..########.........###......###...#######..........................##############......................########..............#
##...#######.........###.......##...########........................#####...######.......................#######..............##
##...#######.........###.......##..###..#####......................######....##...........................####.........###....##
##....#####..........###......##.........####....#................#######..................................##...........#.....##
##......##..................###............###..###..............#######......................................................##
##.........................###..............#######..............#####........................................................##
##........................####...............#####................###.........................................................##
##...##...................####................###.............................................................................##
##..####..................####.#..............................................................................................##
##...##....................###.##....................#........................................................................##
###........................###.###............................................................................................##
####........................######............................................................................................##
#####.........................####...........................................................................................###
#####..........................##............................................................................................###
#####..................................................................................##....................................###
######...............................................................................#####...........##.......................##
######....##..................##....................###.............................######..........####......................##
######...###.................###....................######..........................######.........#####.......................#
#####....##...................#......................######.........................#######.......#####........................#
###...................................................####.........................########....................###............##
##......................................................................###.......########......................#...........####
##.....................................................................####......#######....................................####
#......................................................................####...#########.....................................####
#......................................................................###....########.......................................###
#....#####....................................................................#######.........................................##
##..######......................................................................####..........................................##
#######.......................................................................................................................##
######........................................................................................................................##
######......................................###..........##..................##...............................###.............##
######.....................................#####........####................####..............................###.............##
#####......................................#####.......#####...##......#....#####............................####.............##
####..................###............#......#####......###..#####...........#####.............................##..............##
###..................#####...................#####..........#####............####....#........................................##
##..................######...................#####..........###.....................###.......................................##
##..................#####....................#####..........##.......................#........................................##
##...................##......................#####.........###................................................................##
##..........................#................######.......###................................................................###
###........................###....###.........######......##................................##...........................#######
####......................###....####............####......................................####.........................########
####.....................####....####.............####.....................................####........#................########
####....................####......##..............####.....................................###...........................#######
###....#...............####........................##.....................................................................######
##.....##..............####..........................................#.....................................................#####
##......................###.........................................###............................................#.........###
###......................#.....#.....................................#............................................##..........##
###...........................###..................................................................................#..........##
####...........................#...................................................#..........................................##
####.............................................#####.............................##.........................................##
###.............................................#######............................#####......................................##
##..............................................#######..............................###......##..............................##
##..............................................#######...............................##....####..............................##
###........................###..................########...................................#####..............................##
####......................#####.................########...................................######....##.......................##
####......................#####........####.....#######....................................#############.......................#
####.......................###........#######....######.....................................###########........................#
###........................###.......#########....######........................................######.........................#
###........................##.......#######..##......###.........................................####..........................#
##........................###.......######....##......##......................................................................##
##.......................####......######......................##.............................................................##
##..........##..........####.......####.......................####.............##.............................................##
###........####.........####......####.......................######......##..#####..........................##.........##....###
##################.....######....######..####...####...##...#######################....###############..########################
################################################################################################################################
