################################################################################################################################
#####################################################################.......................................................####
##...###################..#####...##..##################...########......##################################.#############....###
#.....#######....######....##...........######..#######.....................##.....#####..###########........####...#####....###
#......#####..............................###....######..............................##...#####.............####....######...###
##......###......................#.........###.....#####..................................#####..........######.....######...###
###.....................#.......###.........#.......#####........#........................#####.........######......#####....###
####...................###......###..................#####.......##.......................#####.........#####........##.....####
#####...................#........##..................#####.......#.........................###...........###...............#####
#####.............................#...................###........................##..##..................##................#####
####.....#####..................................................................#########................##................#####
####....#######................................##...........##.................###########..............###.................####
####.....##..###.............................#####.........#####..............#######..####..............#...................###
###...........###............................#####....#....######...###......######.....###...................................##
###...........###.............................#####..###....#############....#####.......#....................................##
##.............##..............................#########.....#############....##...............................##....##......###
##.......................................##....#########......#####..#####.................................#############...#####
##......................................####....####..................####................................##############...#####
##......................................#####....##...................###..........##.....................#############....#####
###...####...............................#####........................###........#####...##................##########......#####
##########.................................###.........................#........######..####.................######........#####
##########....##................##..........###......####......................######...####..................##.............###
#########.....##...............####.........###.....######........##..........#######....##...................................##
#########.......................##..........####.....######......####.........########........................................##
#########...................................######....#####......#####.........########.......................................##
#########............................##.....#######....####.......#####........#########.......................................#
########............................####....########....###........####.........########............##.........................#
#####...............................####....########.....#..........##..........#######............####.......................##
####.................................##.....########.....#......................######............#####....................#####
###....###.........#........................#######.....###.....................######...........######..............##....#####
###...######......###.......................######.....####......................#####...#####.#######..............####...#####
##....#######..............................#######.....####.................##.....##...######.######..............######...####
#......######..............................########....###..........##......##..........######.######..............######....###
#.......#####.............................#####..###..####.........####.....##...........####...####..##............####.....###
##.......####.............................####....#########........###....................###........###....................####
###.......##...............................###....##########......####.....................#........####.....#.............#####
####...............................................##...#####....#####.............................####.....###............#####
###..................................###.................#####...####..............###............####......###............#####
##.....................##...........####.................######..##...............#####............##......####..............###
##.......####.........####..........###.........####.....######......######.......#####...................######..............##
##......########.....#####...........#.........#####......#####.....#######......#####...................########.............##
#.......########.....#####................#########.......#####....#########....#####....................########.............##
#........#######.....######..............#########........####....###################....................########......#......##
#.....................######............#########..........##.....####################...................#######......###.....##
#......................######.........##########...................####...#############...................#####......####....###
#.......................######.......##########.......##...........###.....##...#######.......###..........####......#####..####
##..###.................######........########.......###...........###...........######.....#####...........####......####.#####
########................######........########.......###......##..####...........####......#####............####.......###.#####
########................#####.........########.......##......########.......##..####.......####.............####........##.#####
###########.............####.........########........##......#######........#######.........##...............##............#####
############.............##.......#######...........###.........####........#######.........................................####
#####...###.......................#####.............###.........####........######...........................................###
####............#................####..........##...##..........#####........####.................................##.........###
####...........###..............####..........####..............######..................##.......................#####........##
####...........###..###........####...........####..............###########.............###......................######.......##
####...###.....##...###........####............##..............#############............###..................#...######........#
####...###.....##...###.........##........##...................####..#######............###..................#...#####.........#
####...###.....##....###.................###.................#####....#######......##....###.....................####..........#
####...###.....###....####..............####................######.....######...######....####...................###...........#
###########...####....####..............###.................#####.......####....######.....####...............................##
###########...####...####....................................##.................#######....####...............................##
###########..#####...####....................###...................................####....####...............................##
###########..####....####...................#####...................................##.....#####.............................###
###########..###......####..................######.........................##...............#####......................###.#####
################......####...................#####.........................###................#####......#...........#####.#####
###############......######...................####.........................##..................#####...............#######.#####
###....########......######..............##...#####............................................#####..............########.#####
##......######.......#######...........#####..#########.............##.........................####...............########.#####
##.......#####........######..........#################............####.........................##.................#######.#####
##........#####........####..........##################............####..............................###................##.#####
##.........######......####..........#################..............##..............................#####................#.#####
##..........#######...#####.........###########...........................##.........................###................##.#####
##..........###################.....#########.............................###...........................................##.#####
##..........####################.....#######..............................###................#...........................#.#####
##.........#########.........#####....######..........................##...##...............###..................###.....#.#####
##.....############...........#####...######..........................##....................###................######......#####
##.....###########..............####..######..........................##...................####...............#######......#####
##.....##########................##########...............................................######..............######.......#####
###.....#########...................######....................#####.......................#######......####....#####.......#####
####.....#########...................####.........#..........#######......................########....######.....##........#####
######...##########..................####........###.........#######................##....#########..#######...............#####
#######..##########...................###........####.......#######................####...########..#########...............####
##...#...##########....................##.........###......#######.................###########......##############..........####
#..........########....................##..........##....#######.......##.........###########.......###############.........####
#...........######.....................##..........###..######.......#####........###########.......##############.........#####
##..........#####......................###.........##########.......#######........###########......#######..............#.#####
####.........###.......................###.........#########.......#########.......############....#######..............##.#####
#####..................................###........##########.......#########......#######################...............##.#####
######.................................###.......###############....#######...##########################..........###....#.#####
######................................####......################....#####....########.....###########............####........###
######................................####.......##############......###....########......########..............#####........###
#####.....#######.....................####..........######.####......##....#########......#######...............#####.......####
####.....########......................##...........#####...##......###...#########.......######.................###.......#####
###.......#######...................................#####..........####...####............####.............................#####
###.......######........#............................###..........#####...###............####......###...................#.#####
###........####........#######...................................#####....###............####.....####.................###.#####
###.........##.........#######.............................###..#####.....###............###......####...............#####..####
##......................######.....................##.....##########.......#.............##........##.....#.........#####....###
##.......................####....................#####....#########.......................................##........####.....###
##.................#...................###.......#####....########...........##..............###..........#....##..####......###
###...............###..................###.......####......######...........####............#####..............#######.......###
######............##..................####.................#####............####.......##..######...............######.......###
#######...........##.................#####..................####............####......###########................#####.......###
#########........####................####.....##............####.............##......###########.................######.......##
#########........####...........##....##.....####..........####......................##########..................#######......##
#########........####..........####........######..........####......................##########..................#######.....###
#####..............##..........####.......########.........#####.....................#########....................######...#####
####................##.........####........########........#######...................######...................##.######...######
#####...............###........####...........######........#######...................####............##....##########....######
#######............######.......####...........#####..........####....................####...........#################.....#####
########..........######.........##......###..#####............##......................##............##################.....####
########.........#######................###########...................................................###################....###
########........#########...............##########........###..................#.......................#######..##########...###
########.......###########...............########........#####................##...............######.....##.....##########.####
########......#####..######..............####...........######.................#......##.......#######............##############
#########....#####....######.............####..........#######.......................####.......#######............#############
#########....####......#####.............####..........######........................####........#######.................#######
#########....###........................#####......#..######........................####..........######....................####
#########.....#....####..............########.....#########.........................###...........#####....##................###
#########.........######............########.......#######..........................###..........######...######.............###
#########..........#####............########........#####...........................###...........######.########...........####
###..####..........#####......###....##..###.........###.....#.......................###.............############..........#####
##....##............####......###.........###........###....###..........###..........###.............##########...........#####
##..........##......####......###.........###........###....####........#####.........####............#########.............####
##.........####....######................####........###....#####......######.........#####..........##########..............###
###......#################..............######.......###....#######..########........###########################....####.....###
#################################......###########..#####..###################...################################..######...####
################################################################################################################################
