################################################################################################################################
##..####...####################......#######........######....#####..#############..###..####....#######...##...###..###########
#....##.........###.........##.........####..........###..............####.........................###....................######
#.......................................##............................####.................................................#####
##....................................................................####..................................................####
##....................................................................####...................................................###
#............###......................................................####....................................................##
#.............#......................................................####.....................................................##
#...............................#...................................###........................................................#
##.............................###................................####.........................................................#
##..............................##...............................###...........................................................#
##..............................................................###...........................................................##
##.............................................................###............................................................##
##.............................................................###............................................................##
##..............................................................#.............................................................##
##............................................................................................................................##
##............................................................................................................................##
###.##...............##......................#.........................................#.................................#.....#
######...............###....................##........................................###......................................#
######................#......................#........................................###......................................#
#####..................................................................................##......................................#
#####..........................................................................................................................#
####................................................................##.........................................................#
###................................................................####.......................................................##
##..................................................................###.......................................................##
##..................................................................###.......................................##..............##
##..................................................................####......................................##..............##
##...................................................................###......................................##..............##
###...................................................................##......................................###.............##
####.........................................................................................................#######...........#
####.........................................................................................................#######...........#
###..........................................................................................................#######...........#
##............................................................................................................#####............#
##.............................................................................................................................#
##.............................................................................................................................#
###............................................##..............................................................................#
####..........................................####.............................................................................#
####.........................................######............................................................................#
###..........................................######...........................................................................##
##...........................................#####............................................................................##
##.....##.....................................###.............................................................................##
###...####....................................................................................................................##
###...####....................................................................................................................##
###....##.........................................................................................###.........................##
##................................................................................................###........................###
##................................................................................................###.......................####
##....................##...................................................................................................#####
##...................####..................................................................................................#####
##...................####..................................................................................................#####
##....................##............................................................###.....................................####
##.................................................................................####.....................................####
#.................................................................................####.......................................###
#.................................................##..............................###.........................................##
#.............................##.................####............................####.........................................##
#.............................###.................##.............................####........................................###
##............................###.................................................##........................................####
###...................##.......##..............................................................##............................###
###...................##........................................#...............................##...........................###
###............................................................###..............................##............................##
###..........................................#..................#...............................##............................##
##..........................................###.....................................................................##........##
#............................................###...................................................................####........#
#............##..............................###...................................................................###.........#
#............###....................................................................................................#..........#
##...#........#...............................................................................................................##
##..###.......................................................................................................................##
##...........................................................................................................................###
###................................##.............##.........................................................................###
###................................##.............###........................................................................###
###...#...........................##..............##..........................................................................##
##....#..........................##.......................................##..................................................##
##...............................#.......................................####........#........................................##
##........................................................................######....###.......................................##
##..............###.......................................................######.....#.........................................#
##.............#####.......................................#...............#####...............................................#
###............#####......................................####................................................................##
###.............###.......................................#####...............................................................##
##.........................................................####...............................................................##
#..........................................................###.................................................................#
#...........................................................#..................................................................#
#..............................................................................................................................#
#..............................................................................................................................#
##.................................................................................................##..........................#
###...............................................................................................###.........................##
###...............................................................................................###.........................##
###..............................................................................................####.........................##
###.........................................................#.....................................##...........................#
##.........................................................###.................................................................#
##.............#...........................................###................................................................##
##............###..........................................###................................................................##
##.............#...........................................####..............###..............................................##
##.........................................................####.............#####............................................###
##..........................................................##.............######............................................###
#...........................................................................#####............................................###
#..............................................................................###....................................##......##
#........#.......................#..............................................######................................##......##
##.......##......................#.............................###..............######................................##......##
###......#....................................................######............####..........................................##
####.........................................................########............##...........................................##
####.........................................................#######..........................................................##
###........................##.................................#####...........................................................##
##.........................###..................................##...........................................................###
##.........................####.........................................#...................................................####
#...........................##...........#.............................###..................................................####
#.......................................##.............................####............####.................................####
#........................................#..............................##.............####......###.........................###
##.......................................................................................##......####.........................##
##...............................................................................................####.........................##
##................................................................................................###.........................##
##.................................................##..............................................#..........................##
##................................................####.......................................##..............................###
##................................................###.......................................###..............................###
##...............................................###.........................................#...............................###
##..............................................###.........................................................................####
###...................###......................###..........................................................................####
###..................#####....................###...........................................................................####
###..................######...................###............................................................................###
###..................#######..................###.............................................................................##
###...................######............................................................#.....................................##
###.....................#####...........................................................................................#.....##
###......................######........................................................................................###....##
###........................#####........................................................................................##....##
###.........................####..............................................................................................##
####.........................##...............................................................................................##
#####.........................................................................................................................##
#######............##..###......................................................###......................................##..###
################..###########....####...##########...###....###..#######...###################...#######.....####..#############
################################################################################################################################
