################################################################################################################################
#############....#######.....###########...#####....###....###..#######......###...#######..#####.....###........###############
###########........####.......##....###...........................................................................###..#########
##...####...............................................................................................................########
##...###.................................................................................................................#######
#...................................................................##....................................................######
#...................................................................##......................................................####
#............................................................................................................................###
##............................................................................................................................##
##.................................................................................................##.........................##
##................................................................................................####........................##
##................................................................................................#####.......................##
#.................................................................................................#####............#..........##
#..................................................................................................###........................##
##..................................####......................................................................................##
##............................##....####......................................................................................##
##...........................####....###..................................................#..................................###
##...........................####........................................................###.................................###
##............................##.........................................................###.................................###
##..........................................................####..............................................................##
###........................................................######.............................................................##
###........................................................######.............................................................##
###.........................................................####..............................................................##
##............................................................................................................................##
#..............................................................................................................................#
#..............................................................................................................................#
##..........................................................##.................................................................#
###........................................................####...............................................................##
###.......................................................#####..............................................................###
###......................................................#####...............................................................###
##.............................#........................####.................................................................###
##......................................................###..................................................................###
##............................................................................................................................##
##.............................................................................................................................#
#..............................................................................##..............................................#
#.............................................................................###..............................................#
#.............................................................................###..............................................#
#............................................................................####......................##......................#
##..........................................................................####.......................###...##................#
##..........................................................#...............##.........................#########..............##
##.........................................................###..........................................########..............##
###..............................##.........................#............................................#######..............##
###.............................####.....................................................................#######.............###
###..............................###....###..............................................................#######.............###
###.....................................###...............................................................#####..............###
##...........................................................................................................................###
#............................................................................................................................###
#...................................................................##......................................................####
##.........................................................................................................................#####
##.....................##..........#.......................................................................................#####
##....................####.................................................................................................#####
#.....................####..................................................................................................####
#......................##......###...........................................................................................###
#..............................####...........................................................................................##
#..............................####.....................................................................##....................##
#...............................##.....................................................................###....................##
#.....................................................................................................####.....................#
#.....................................................................................................###......................#
#......................................................................................................#......................##
##............................................................................................................................##
###.....................................................................####..................................................##
###....................................................................######..................................................#
###....................................................................#####...................................................#
###.....................................................................###....................................................#
###.....................................................................###....................................................#
##......................................................................###..........................................##........#
##................................................#.....................###..............#.....................................#
##.............................................................................................................................#
##....##.......................................................................................................................#
###..####...............###.................##.................................................................................#
###..#####.............####................######..............................................................................#
###...####..............##.................######......##......................................................................#
##.....####.................................#####.....####.....................................................................#
##.......##...........................................####....................................................................##
##........#............................................##.....................................................................##
##........##..................................................................................................................##
#.........###..........................................................................................##.....................##
#.........###........................................................................................#####....................##
#..........#........................................................................................######....................##
##...........................##....................................................................#######....................##
###......................#######...................................................................#######....................##
###......................######.....................................................................######....................##
###......................####..........................................................................##.....................##
##............................................................................................................................##
##............................................................................................................................##
#.................................................................#...........................................................##
#...............................##...............................###..........................................................##
##.............................####...............................#..................................#........................##
##..............................###.................................................................###.......................##
##...............................##..................................................................##.......................##
##...........................................................................................................................###
###.........................................................................................................................####
###.........................................................................................................................####
##..........................................................................................................................####
##..........................................................................................................................####
##..........................................................................................................................####
###........................................................................................................................#####
####.........................................................................###............................................####
####.........................................................................###.......##.....................................##
###..................##.......................................................#.......####.....................................#
##........#..........##...............................................................####.....................................#
##.......###.........##................................................................##......................................#
##........#....................................................................................................................#
##.............................................................................................................................#
###............................................................................................................................#
###.......................................#....................................................................................#
###......................................###...................................................................................#
##........................................##...............................................#..................................##
#.........................................................................................###..................##............###
#..........................................................................................#....................#............###
#.............................................................................................................................##
#....................###......................................................................................................##
##...................###.......................#..............................................................................##
##..................####......................###.............................................................................##
##...................##........................#.........##...................................................................##
#.......................................................####...................................................................#
#................#......................................####...............................................#...................#
#...............###.....................................###................................................##..................#
#..............####............................................................................................................#
#..............####.................................................................................................##........##
#..............####.................................................................................................####......##
#...............##.............###..................................................................................####......##
##............................####...................................................................................###.......#
##...........................######..................................##........................................................#
##...........................#######......................#######...####..........................##..........................##
###..####...................#########....................#########.######......................######....####................###
#####################...##############..########################################...######....#################..#########...####
################################################################################################################################
